##
## A list of package upstreams located on Github which should be
## checked for updates.
##
## Each entry has a following format:
##
##   {package name}|{project path on Github}
##
## Example: acr|radare/acr
##
## Lines starting with "#" are comments.
##
## Packages which are known to be problematic, big or just should
## never be updated must be commented out with appropriate description
## added.
##

## No tags.
#8086tiny|adriancable/8086tiny

acr|radare/acr
antibody|getantibody/antibody
atomicparsley|wez/atomicparsley
axel|axel-download-accelerator/axel
bash-completion|scop/bash-completion
bat|sharkdp/bat
beanshell|beanshell/beanshell

## Not sure whether it can be updated without consequences.
#binaryen|WebAssembly/binaryen

## Returns 'null' in latest tag.
#blackbox|StackExchange/blackbox

bmon|tgraf/bmon
brook|txthinking/brook
brotli|google/brotli

## No sources because a metapackage. Belongs to @termux.
#build-essential|termux/termux-packages

cava|karlstav/cava
ccnet|haiwen/ccnet
cicada|mitnk/cicada
clash|Dreamacro/clash
cmark|github/cmark
cmatrix|abishekvashok/cmatrix
cmusfm|Arkq/cmusfm

## Belongs to @termux - no auto updates.
#command-not-found|termux/command-not-found

cpulimit|opsengine/cpulimit
croc|schollz/croc
cronie|cronie-crond/cronie
ctypes-sh|taviso/ctypes.sh
delve|go-delve/delve
deutex|Doom-Utils/deutex
direnv|direnv/direnv
diskus|sharkdp/diskus
dns2tcp|alex-sector/dns2tcp
dnsmap|resurrecting-open-source-projects/dnsmap
double-conversion|google/double-conversion
duf|muesli/duf
dvtm|martanne/dvtm
eja|eja/eja
elvish|elves/elvish
espeak|espeak-ng/espeak-ng
fasd|clvv/fasd
fastmod|facebookincubator/fastmod
fd|sharkdp/fd
fdupes|adrianlopezroche/fdupes
flex|westes/flex
fribidi|fribidi/fribidi

## Uses git checkout.
#frogcomposband|sulkasormi/frogcomposband

fselect|jhspetersson/fselect
fsmon|nowsecure/fsmon
fzf|junegunn/fzf
fzy|jhawthorn/fzy

## Termux repository configuration package. No auto updates.
#game-repo|termux/game-packages

gbt|jtyr/gbt

## Belongs to @termux - no auto updates.
#getconf|termux/getconf

gflags|gflags/gflags
gh|cli/cli
git-delta|dandavison/delta
git-lfs|git-lfs/git-lfs
google-glog|google/glog
googletest|google/googletest
gotty|yudai/gotty
gping|orf/gping
gumbo-parser|google/gumbo-parser
hexcurse|LonnyGomes/hexcurse
hexyl|sharkdp/hexyl
hiptext|jart/hiptext
hoedown|hoedown/hoedown
hors|WindSoilder/hors
hub|github/hub
hydra|vanhauser-thc/thc-hydra
hyperfine|sharkdp/hyperfine
imgflo|imgflo/imgflo
inotify-tools|rvoicilas/inotify-tools
inxi|smxi/inxi

## Getting sources from Fossies mirror.
#iperf3|esnet/iperf

ired|radare/ired
jftui|Aanok/jftui

## Getting sources from Amazon S3 bucket.
#json-c|json-c/json-c

jsoncpp|open-source-parsers/jsoncpp
kakoune|mawww/kakoune
kibi|ilai-deutel/kibi
kona|kevinlawler/kona
lazygit|jesseduffield/lazygit

## Complex package - no auto updates.
#ldc|ldc-developers/ldc

leveldb|google/leveldb
lf|gokcehan/lf

## Belongs to @termux - no auto updates.
#termux/libandroid-shmem

## Belongs to @termux, complex package. No auto updates.
#libandroid-support|termux/libandroid-support

libass/libass/libass
libconfig|hyperrealm/libconfig
libconfuse|martinh/libconfuse
libcue|lipnitsk/libcue

## Part of Swift - disable auto updates.
#libdispatch|apple/swift-corelibs-libdispatch

libebml|Matroska-Org/libebml
libgit2|libgit2/libgit2
libgraphite|silnrsi/graphite
